11111111111111111111111111111
100000000000000000000001000C1
1010000000011110000C0010011111
1001000000110001110011000001C1
100000011111E10010000001011101
100111000000111010101110000001
101C00010010001000000001111111
1011111111111111111C11111
100000010000000001101
101111010111C01000001
1011P1C10000110010111
1000011100111001C01
1111000001C00011111
   111111111111