111111111111111111111111111111
100000000000000000000001000C11
1010000000011110000C0010011111
1001000000110001110011000001C1
100000011111E10010000001011101
100111000000111010101110000001
101C00010010001000000001101111
1011111111111111111C11101000C1
100000010000000001101100100111
101111010111C01000001101101C01
1011P1C10000110010100001101101
1000011100111001C0111111000001
1111000001C000111111C000011111
111111111111111111111111111111