1111111111111111
1P00000000000001
1111100100011001
1000C10C1100C101
10011C1100011001
10000000001E0001
1111111111111111