1111111111111
10000000C0001
10P0000000001
1000000000E01
1000000000001
100C000000001
1111111111111